10 7
0 0
5 1 1 1 1 1 1 1 1 6
3 0 0 0 0 0 0 0 0 4
3 0 0 0 0 0 0 0 0 4
3 0 0 0 0 0 0 0 0 4
3 0 0 0 0 0 0 0 0 4
3 0 0 0 0 0 0 0 0 4
7 2 2 2 2 2 2 2 2 8